TTTSSSTTTSSSTTT
SLS   SLS   SLS
SLST  SLS  TSLS
SLS TTSLSTT SLS
SLS   SLS   SLS
SLST  SLS  TSLS
SLS TTSLSTT SLS
SLS   SLS   SLS
SLST  SLS  TSLS
SLS SSSLSSS SLS
SLS   SLS   SLS
SLSLLLSLSLLLSLS
