   s s s s s s s s 
  s s s s s s s s S
 TTTTTTT     LLLLTT
LLL              TT
 TTTTTTT     LLLLTT
  s s s s s s s s S
   s s s s s s s s 
 S s s s s s s s   
S s s s s s s s s  
TTLLLL     TTTTTTT 
TT              LLL
TTLLLL     TTTTTTT 
s s s s s s s s S  
 s s s s s s s s   
