TTTTTTTTTTTT
T          T
T   T  T   T
T          T
T  TTTTTT  T
T   T  T   T
T          T
TTTT    TTTT
   T    T   
 TTT    TTT 
