SSSSSSSSSSSSSSSSSSS
                   
STTTTTTTTTTTTTTTTTS
SSSSSTLLLLLLLLTSSSS
   STLLLLLLLLLTS   
   STLLLLLLLLLTS   
SSSSSTLLLLLLLLTSSSS
STTTTTTTTTTTTTTTTTS
                   
SSSSSSSSSSSSSSSSSSS
