     SSSSSSSSS     
   SSLLLLLLLLLSS   
  SLLLLLLLLLLLLLS  
 SLLLLLTLLLTLLLLLS 
 SLLLLLLLTLLLLLLLS 
 SLLTTLLLLLLLTTLLS 
  SLLLTTTTTTTLLLS  
   SLLLLLLLLLLLS   
    SSSSSSSSSSS    
