      TTTTTTT     
 TTss         ssTT
    s sTTTTTs s   
    T         T   
  TTssTT   TTssTT 
    T         T   
  TTssTT   TTssTT 
    T         T   
 TTTT         TTTT
      sssssss     
