TTT   SSS   TTT
TTT         TTT
  SLLL   LLLS  
    SLL LLS    
  SLLL   LLLS  
TTT         TTT
TTT         TTT
